010001111100010001000010001001000000000
010100100011010101011000100101011111110
010110011011000101000101110101000000010
000001001010011101110100100000011111100
111110100011000100010101101111100000010
100000001101010101100011000001001111010
101111111101010100101011101010011011010
100001100000010101101011001110110000010
110100001010100101001011101000110111110
000111111101111001111011101110010000000
110001001000000100000000101010111111111
011101101011110110111101101010100000001
010110101000110101110101100010101011100
000000001010110000000001101110101101101
101111101010001111011110001000101000001
101000101011111011111011101010101010100
101011001000000000000000000110101011111
101000101111111111111111111010101000000
101010100000000000000000000000101111110
101010111111111111111111111111101101000
100010000000000000000000000000001000011
001001011110111101110101101110110011000